.....................
.....................
.....................
.....................
.....................
...........CCC.......
...........###.......
......CCC............
......###.......CCC..
................###..
.###.................
.....................
.....................
#####################
