...................
...................
...................
...................
...................
...................
...........CCC.....
...........###.....
......CCC..........
......###.......CCC
................###.
.###................
....................
####################
